0 0 1 2 1 3 0 0 8 3 6 2 6 0 6
0 5 8 5 8 7 8 0 0 7 1 2 1 0 0
2 1 2 1 2 3 0 8 8 3 6 8 6 8 6
8 5 8 5 8 7 8 0 0 7 2 1 2 1 2
1 2 1 2 1 3 0 0 8 3 6 8 6 8 6
2 5 2 5 2 7 8 8 0 0 1 2 1 2 1
7 3 7 3 7 3 0 0 8 3 7 3 7 3 7
1 2 1 2 1 0 8 0 0 7 1 5 1 5 1
4 8 4 8 4 3 0 8 8 3 2 1 2 1 2
2 1 2 1 2 7 8 0 0 7 8 5 8 5 8
4 8 4 8 4 3 0 0 8 3 1 2 1 2 1
0 0 1 2 1 7 8 8 0 7 8 5 8 5 0
4 0 4 1 4 3 0 0 8 3 2 1 2 0 0
