0 0 2 2 2 2 2 0 0 2 2 2 2 0 0
0 1 2 3 2 5 8 5 0 1 7 1 2 0 0
2 2 2 2 2 2 2 2 2 2 2 2 2 2 2
2 5 6 5 2 4 2 5 2 3 2 5 2 4 2
2 2 2 2 2 2 2 2 2 2 2 2 6 2 2
0 3 2 5 2 1 2 1 6 1 2 1 2 5 2
0 0 2 2 8 2 2 2 2 2 2 2 2 0 0
2 4 2 1 2 1 2 5 2 4 2 5 6 5 0
2 2 2 2 2 2 2 2 2 2 8 2 2 2 2
2 3 2 5 6 5 2 1 2 1 2 1 2 5 8
2 2 2 2 2 2 7 2 2 2 2 2 2 2 2
0 5 2 5 2 3 0 5 2 1 2 5 2 4 0
0 0 2 2 2 2 0 0 2 2 2 2 2 0 0


