0 0 3 1 4 3 1 2 0 2 3 2 3 2 1
0 0 4 2 3 3 0 4 4 0 2 3 2 1 2
3 1 11 13 13 15 4 0 4 11 13 15 4 0 4
1 3 10 12 12 14 2 3 0 10 12 14 3 3 4
2 2 1 1 2 2 3 2 1 2 2 1 1 2 2
3 3 0 0 3 3 1 1 3 4 4 2 2 1 1
0 4 4 1 3 3 1 1 3 0 0 4 4 0 0
4 4 2 2 4 0 2 0 4 4 0 0 2 3 2
3 0 0 0 0 0 11 13 13 13 13 15 3 2 0
2 1 0 3 0 1 10 12 12 12 12 14 1 1 4
3 3 1 1 4 0 0 0 4 4 3 4 4 3 1
3 3 1 1 3 2 1 0 3 1 3 2 1 0 0
2 4 4 2 0 1 2 0 2 2 4 1 1 0 0