0 0 0 1 3 2 4 0 1 0 0 3 2 4 0
0 0 0 0 2 3 0 0 0 1 1 2 3 0 0
6 7 3 2 0 0 0 9 0 6 7 2 0 0 4
0 4 2 3 0 4 1 1 0 0 0 0 0 2 2
0 0 0 0 0 3 2 0 0 3 3 0 0 0 0
9 0 0 10 0 2 3 0 1 1 0 10 9 8 0
4 3 2 2 3 1 0 0 2 2 0 0 0 2 3
0 0 3 3 2 0 1 0 4 0 0 0 8 1 0
0 8 10 2 3 0 0 0 0 1 6 7 0 0 0
0 0 1 0 0 0 0 2 3 6 7 0 0 0 0
3 3 0 6 7 0 4 0 2 0 3 2 6 7 1
2 2 1 1 0 2 2 9 0 10 2 3 0 0 0
0 4 3 0 2 3 0 0 1 0 1 2 0 0 0