0 0 1 1 0 4 0 0 0 1 0 0 5 0 0
0 0 0 6 0 5 4 6 0 0 0 0 0 4 0
1 5 0 5 6 4 5 5 3 0 0 3 0 0 6
5 4 5 4 5 0 0 4 6 6 0 5 5 5 5
0 3 0 6 4 0 0 1 2 6 0 1 0 2 6
0 3 3 5 4 6 5 0 5 4 0 0 5 4 6
1 5 2 4 5 0 0 0 4 5 5 4 4 0 2
6 4 5 1 0 3 0 6 0 1 4 5 3 3 0
6 2 0 0 6 4 5 0 4 0 0 6 0 3 0
5 5 2 5 1 0 0 0 0 0 0 5 4 5 4
0 4 4 0 6 6 0 5 2 0 6 4 0 4 1
0 3 0 1 6 6 0 2 5 0 0 6 0 0 0
0 0 4 5 0 4 5 0 0 0 0 1 2 0 0
